"Get the hell off of my property!" the man yelled.
 but we couldn't, we where frozen in fear. Violet screamed, the rest of us didn't have the breath. The man cought up to us, grabbed Sean by his color as if he weighed nothing.
 "Were going allready" Daisy yelled, but the man wouldn't listen. Josh started running again, but tripped on a tree branch, and the man cought him too.
HINT: You can use Become (character) to run into another Daisy, Josh, Sean, or Violet. 
Madhouse
A semi-coherent collection of puzzles by Maurits van Riezen
Release 1 / Serial number 151128 / Inform 7 build 6L38 (I6/v6.33 lib 6/12N) SD

You could hardly look. The man was holing you by your arm, and suddendly, you where flying. "there you go, no way of gettting out of there!" the man sneered. You seemed to hit some stairs, and you kept rolling down, and down. You thought you where still rolling when you opened your eyes, but instead you find yourself lying still under a flight of stairs. You examine yourself, your head hurts, you have bruises everywhere, but miraculously havn' broken anything. 
cellar (as Violet)
A small concrete hole in the ground, a narrow concrete staircase leads up, with a iron door above it. Another door is set into the ground on the east. The room is lit with some flickering tubelights on the ceiling. 

You can see a purple key and an iron door(locked) here.

>become daisy
You must have fainted, because at some point, you heared the man saying "Now I am going to leave this old place, and go on a long holiday, good thing you showed up the day before my holiday to Madagascar.!" You heared the sound of a car drive away, you look arround. 
stable (as Daisy)
This room probably used to contain all the old knights finest horses, but some later resident has used this place to keep some of his trash. A big double door leads south, while a narrow door is set into the east wall.A heap of trash, including a newspaper, a pencil, a tyre and a cardboard box has been dumped in the corner. 

[You have received 1 point for figuring out how this game works]

>take blue pen
Just how do you expect to get a thing like that here?

>take newspaper
Yours.

>put newspaper in gap
You put the newspaper into the the crack under the door.

>x gap
In the the crack under the door is a newspaper.

>l
stable (as Daisy)
This room probably used to contain all the old knights finest horses, but some later resident has used this place to keep some of his trash. A big double door leads south, while a narrow door is set into the east wall.A heap of trash, including a pencil, a tyre and a cardboard box has been dumped in the corner.

>poke key with pencil
(I recomend saving before you try this, would you like to save first?)

>n
You poke the key, and it falls out the other side.

>take newspaper
You find the key on the newspaper! It falls on the floor after you take the paper.

>take key
Yours.

>unlock narrow door
(with the plain key)
You unlock the narrow door.

>e
(Opening the narrow door first)
brick hallway (as Daisy)
A long and clausrophobically passage running through the oldest part of the castle. The walls are are made of roughly cut grey stone, the floor is rough, and hurts your feet to walk on. Halfway the passage, a tall door leads north, and both the east and west end in doors. 

You can see a west door(open) and a tall door(closed ) here.

[You have received 1 point for getting daisy out of the stable]

* * *

>take all
newspaper: Yours.
pencil case: Yours.
tyre: Yours.
cardboard box: Yours.
pencil: Yours.
pencil: Yours.
pencil: Yours.
blue pen: Yours.
blue pen: Yours.
black pen: Yours.
plain key: The keyhole is to small to reach the key.

>l
stable(as Daisy)
This room probably used to contain all the old knights finest horses, but some later resident has used this place to keep some of his trash. A big double door leads south, while a small door reveals the passageway to the east.

* * *

>become josh
"here ya go" the man yelled "you will never get out of here untill you rot!" He threw you into the small room, you hit your head again some kind of box, you could just hear the man stomp out the door, locking it behind him. 
attic (as Josh)
A small room, probably later cut off from the rest of the cellar. The walls are made of wooden planks, pretty new relative to the old floor. The ceiling runs diogonally down one side, there is a window in the ceiling

You can see an inside attic window(locked) and a broad box (closed) here.

[You have received 1 point for figuring out how this game works]

>x floor
The floor is made of very old planks, nailed to a layer of beams below.  One plank seems a bit loose.

>pull plank
You pull at the board, and it comes of the ground a little, you pull a little more, and then the plank snaps in half, laving a gaping hole in the floor. 
Nothing obvious happens.

>pull board
You pull at the board, and it comes of the ground a little, you pull a little more, and then the plank snaps in half, laving a gaping hole in the floor. 
Nothing obvious happens.

>enter hole
You first look down, but then decide not to and just jump. Luckily, you land on a bed after falling a couple of meters, you bounce of the bad and land in a aquard heap on the floor. 
(Opening the hole in the floor first)
green bedroom (as Josh)
A square room, newly painted, and with a nice, comby bed. Next to the bed is a cabinet .

You can see a cabinet here.

* * *

>e
maintanance room (as Violet)
This is a long room, with a low ceiling. A doorway goes west. The room is filled with pipes of all shapes and sizes, including some narrow metalic blue pipes, some very wide concrete pipes, and in between there is one rusty red pipe of a medium width.  

You can see a plug here.

>become sean
You put up a good fight, you kept biting, scratching and prying. "you think you are smart resisting like that? Stupid mormel you are!" the man yelled. He threw you into the the first door he passed. You heared sounds like a heavy wooden object was moved in front of the the door, and you heard "You will never get out of there, moron!" 
Darkness
It is pitch dark, and you can't see a thing.

>turn tap
Just how do you expect to get a thing like that here?

>become violet
maintanance room (as Violet)
This is a long room, with a low ceiling. A doorway goes west. The room is filled with pipes of all shapes and sizes, including some narrow metalic blue pipes, some very wide concrete pipes, and in between there is one rusty red pipe of a medium width.  

You can see a plug here.

>x medium
A very rusty pipe comes in threw the ceiling into the north wall. A segment that has recently been replaced.

[You have received 1 point for figuring out how this game works]

>x segment
A half-meter long matte piece op pipes, with screws bits on both ends.

>unscrew segment
The segment comes loose in your hand as you unscrew it!

>take plug
Yours.

>attach plug to segment
You try, but they both have the same type of screw, so you can't attach them.

>attach plug to medium
You attach the plug to the segment.

>turn tap
You turn on the tap. You hear the gurgling noise of air being pushed out the tap.

>become sean
Darkness
It is pitch dark, and you can't see a thing.

>feel
You search the walls, and finally find a lightswitch.

bathroom (as Sean)
A longish room. To the west is a door, you can see a sink, with a tap. There is a drain in the corner. 

You can see a black bag (closed) and a plastic door(locked) here.

>x sink
(the sink)
A ordinary porcelain sink, it hang a bit crookedly. On top of it is a tap.

>turn tap
It's one of those sinks where water going down the draisn simply empties over the floor. A stream runs into the drain, and spreads down from there. .

>open bag
You open the black bag, revealing a screwdriver, a roll of plumbing tape and a wrench.

The murky water covers the whole floor now, and is rising steadily.

>take all from bag
screwdriver: Yours.
roll of plumbing tape: Yours.
wrench: Yours.

The water comes up to you enkles now.

>x screwdriver
A big screwdriver, with a green-transparent handle. 

The water rises further, up to your knees now. It's pretty cold!

>unscrew door
Your nails arn't strong enough to unscrew the screws. 
Up to your waist now, the water seems to come faster

>i
You are carrying:
  a wrench
  a roll of plumbing tape
  a screwdriver

The mirky water goas higher still, you probably could swim now.

>unscrew door with tape
The action prooves ineffective. 
You can breath is you stand on your toes and breath, good thing you know how to swim!

>unscrew door with screwdriver
The door falls out of it's post
The water stops rising, just short of the light bulb. It probably has to do something with water pressure, but you are no scientist, you have no idea. You are floating near the ceiling.

>w
You dive under the top of the door. 
study (as Sean)
 Here is a circular room, fancily decorated by a old carpet and a tapestrie on the walls, none in a very good shape.  Floors and walls are made of smooth marble. A staircase roates arround the walls, but a large chunk seems to be missing. You wonder how the man got out of here, then you see a ladder pulled up into the doorway above you. High in the wall to the west, a the staircase ends near a open door, now seemingly leading nowhere. The entire staircase and everything else is under water, it even splashes into the door to the west a bit.

>x floor
It's made of marble.

>x ceiling
The ceiling is made of long flat stones, supported by wooden beams.

>x walls
Filled with a circular marble pattern, looks a bit like a panter.

>x wall
Filled with a circular marble pattern, looks a bit like a panter.

>x stairs
They would run is a spiral, only the rooms isn't actually tall enough for them to make a full circle. The upper half of the stairs is very virtually non-existant, only now and then a broken off plank that used to be a rung.

>w
You climb out of the water, onto the wallway beyond. (Opening the high up door first)
marble hallway (as Sean)
A wide and long hallway, leading up to some kind of balcony to the north, but you can't make out much to the south. To the east is a spruce door threw wich you can see the study. 

You can see a ladder here.

[You have received 1 point for swiming out of there]

>take ladder
Yours.

>s
marble junction (as Sean)
The marble way continues to the south, and to the north. Another passage, one with stone walls runs from east to west, but some steel bars with planks nailed on attempt to either block or hide the paths. Both objectives are hindered by a large missing plank on the east side, leaving a tall, narrow gap in the fake wall.

>become josh
"here ya go" the man yelled "you will never get out of here untill you rot!" He threw you into the small room, you hit your head again some kind of box, you could just hear the man stomp out the door, locking it behind him. 
attic (as Josh)
A small room, probably later cut off from the rest of the cellar. The walls are made of wooden planks, pretty new relative to the old floor. The ceiling runs diogonally down one side, there is a window in the ceiling

You can see an inside attic window(locked) and a broad box (closed) here.

>x floor
The floor is made of very old planks, nailed to a layer of beams below.  One plank seems a bit loose.

>pull plank
You pull at the board, and it comes of the ground a little, you pull a little more, and then the plank snaps in half, laving a gaping hole in the floor.

>enter hole
You first look down, but then decide not to and just jump. Luckily, you land on a bed after falling a couple of meters, you bounce of the bad and land in a aquard heap on the floor. 
You climb out of the water, onto the wallway beyond. (Opening the hole in the floor first)
green bedroom (as Josh)
A square room, newly painted, and with a nice, comby bed. Next to the bed is a cabinet .

You can see a cabinet here.

>out
wooden hallway (as Josh)
Despite the title, not much of this hallway is actually made of wood. The floor is made of stone, and to the north there is not so much a wall as clay brick towers, with marble planks cemented to the back side. The oppsite wall and the ceiling are made of proper wooden planks. The east door leads to the marble doorway. To the wast, your path has been nailed shut by a collection of planks and . To the east, a door leads to the greed bedroom, to the south, the red one.

>x collection
The path to the west is mostly blocked by planks and bars, but a some perticularly wide gaps are allmost big enough to step threw them. Looking threw the gap, you see a well lit marble-floored hallway, running perpendicular to where you are. Hey, you can see Sean there!

>i
You are empty handed.

>become sean
marble junction (as Sean)
The marble way continues to the south, and to the north. Another passage, one with stone walls runs from east to west, but some steel bars with planks nailed on attempt to either block or hide the paths. Both objectives are hindered by a large missing plank on the east side, leaving a tall, narrow gap in the fake wall.

>give ladder to josh
You give the ladder to Josh.

>become josh
wooden hallway (as Josh)
Despite the title, not much of this hallway is actually made of wood. The floor is made of stone, and to the north there is not so much a wall as clay brick towers, with marble planks cemented to the back side. The oppsite wall and the ceiling are made of proper wooden planks. The east door leads to the marble doorway. To the wast, your path has been nailed shut by a collection of planks and . To the east, a door leads to the greed bedroom, to the south, the red one.

>i
You are carrying:
  a ladder

>x ladder
Usefull if you want to climb stuff.

>give ladder to sean
You give the ladder to Sean.

>undo
wooden hallway
[Previous turn undone. The last thing you did was examining the ladder. ]

* * *

>e
maintanance room (as Violet)
This is a long room, with a low ceiling. A doorway goes west. The room is filled with pipes of all shapes and sizes, including some narrow metalic blue pipes, some very wide concrete pipes, and in between there is one rusty red pipe of a medium width.  

You can see a plug here.

>become sean
You put up a good fight, you kept biting, scratching and prying. "you think you are smart resisting like that? Stupid mormel you are!" the man yelled. He threw you into the the first door he passed. You heared sounds like a heavy wooden object was moved in front of the the door, and you heard "You will never get out of there, moron!" 
Darkness
It is pitch dark, and you can't see a thing.

[You have received 1 point for figuring out how this game works]

>feel
You search the walls, and finally find a lightswitch.

bathroom(as Sean)
A longish room. To the west is a door, you can see a sink, with a tap. There is a drain in the corner. 

You can see a black bag (closed) and a plastic door(locked) here.

>open bag
You open the black bag, revealing a screwdriver, a roll of plumbing tape and a wrench.

>take wrench
Yours.

>put wrench in drain
(opening the drain first.)
You pull the grating of the drain. 

You drop the wrench down the drain.

>open drain
That's already open.

>put wrench in drai
Just how do you expect to get a thing like that here?

>put wrench in drain
Just how do you expect to get a thing like that here?

>become violet
maintanance room(as Violet)
This is a long room, with a low ceiling. A doorway goes west. The room is filled with pipes of all shapes and sizes, including some narrow metalic blue pipes, some very wide concrete pipes, and in between there is one rusty red pipe of a medium width.  

You can see a plug here.

>turn segment
The segment comes loose in your hand as you unscrew it! A wrench appears to have gotten stuck in the segment, but now it falls out.

* * *

>disconnect cellar
No idea what you where trying to say there

>undo
You can't "undo" what hasn't been done!