"Get the hell off of my property!" the man yelled.
 but we couldn't, we where frozen in fear. Violet screamed, the rest of us didn't have the breath. The man cought up to us, grabbed Sean by his color as if he weighed nothing.
 "Were going allready" Daisy yelled, but the man wouldn't listen. Josh started running again, but tripped on a tree branch, and the man cought him too.
HINT: You can use Become (character) to run into another Daisy, Josh, Sean, or Violet. 
Madhouse
A semi-coherent collection of puzzles by Maurits van Riezen
Release 1 / Serial number 151122 / Inform 7 build 6L38 (I6/v6.33 lib 6/12N) SD

You could hardly look. The man was holing you by your arm, and suddendly, you where flying. "there you go, no way of gettting out of there!" the man sneered. You seemed to hit some stairs, and you kept rolling down, and down. You thought you where still rolling when you opened your eyes, but instead you find yourself lying still under a flight of stairs. You examine yourself, your head hurts, you have bruises everywhere, but miraculously havn' broken anything. 
cellar(as Violet)
A small concrete hole in the ground, a narrow concrete staircase leads up, with a iron door above it. Another door is set into the ground on the east. The room is lit with some flickering tubelights on the ceiling. 

You can see a purple key and an iron door(locked) here.

>become daisy
You must have fainted, because at some point, you heared the man saying "Now I am going to leave this old place, and go on a long holiday, good thing you showed up the day before my holiday to Madagascar.!" You heared the sound of a car drive away, you look arround. 
stable(as Daisy)
This room probably used to contain all the old knights finest horses, but some later resident has used this place to keep some of his trash. A big double door leads south, while a narrow door is set into the east wall.A heap of trash, including a newspaper, a pencil, a tyre and a cardboard box has been dumped in the corner. 

[You have received 1 point for figuring out how this game works]

>take blue pen
Just how do you expect to get a thing like that here?

* * *

>x gap
In the the crack under the door is a newspaper.

>l
stable(as Daisy)
This room probably used to contain all the old knights finest horses, but some later resident has used this place to keep some of his trash. A big double door leads south, while a narrow door is set into the east wall.A heap of trash, including a pencil, a tyre and a cardboard box has been dumped in the corner.

>poke key with pencil
(I recomend saving before you try this, would you like to save first?)

* * *

>unlock narrow door
(with the plain key)
You unlock the narrow door.

>e
(Opening the narrow door first)
You open the narrow door.

1st floor east hallway(as Daisy)
A long and clausrophobically passage running through the oldest part of the castle. The walls are are made of roughly cut grey stone, the floor is rough, and hurts your feet to walk on. Halfway the passage, a tall door leads north, and both the east and west end in doors. 

You can see a west door(open) and a tall door(closed ) here.

[You have received 1 point for getting daisy out of the stable]

* * *

>take all
newspaper: Yours.
pencil case: Yours.
tyre: Yours.
cardboard box: Yours.
pencil: Yours.
pencil: Yours.
pencil: Yours.
blue pen: Yours.
blue pen: Yours.
black pen: Yours.
plain key: The keyhole is to small to reach the key.

* * *

>become josh
"here ya go" the man yelled "you will never get out of here untill you rot!" He threw you into the small room, you hit your head again some kind of box, you could just hear the man stomp out the door, locking it behind him. 
attic(as Josh)
A small room, probably later cut off from the rest of the cellar. The walls are made of wooden planks, pretty new relative to the old floor. The ceiling runs diogonally down one side, there is a window in the ceiling

You can see an inside attic window(locked) and a broad box (closed) here.

* * *

>e
maintanance room(as Violet)
This is a long room, with a low ceiling. A doorway goes west. The room is filled with pipes of all shapes and sizes, including some narrow metalic blue pipes, some very wide concrete pipes, and in between there is one rusty red pipe of a medium width.  

You can see a plug here.

>x medium
A very rusty pipe comes in threw the ceiling into the north wall. A segment that has recently been replaced.

>x segment
A half-meter long matte piece op pipes, with screws bits on both ends.

* * *

>attach plug to segment
You try, but they both have the same type of screw, so you can't attach them.

>attach plug to medium
You attach the plug to the segment

>become sean
You put up a good fight, you kept biting, scratching and prying. "you think you are smart resisting like that? Stupid mormel you are!" the man yelled. He threw you into the the first door he passed. You heared sounds like a heavy wooden object was moved in front of the the door, and you heard "You will never get out of there, moron!" 
Darkness
It is pitch dark, and you can't see a thing.

[You have received 1 point for figuring out how this game works]

>feel
You search the walls, and finally find a lightswitch.

bathroom(as Sean)
A longish room. To the east is a door, you can see a sink, and a shower here. There is a drain in the corner. 

You can see a black bag (closed) and a plastic door(locked) here.

>open bag
You open the black bag, revealing a screwdriver, a roll of plumbing tape and a wrench.

>open black
It isn't something you can open.

>x black
A small black bag, made of stif cloth.

>open black
It isn't something you can open.

>showme black
black bag - closed container
    screwdriver
    roll of plumbing tape
    wrench
location: in the bathroom
singular-named, improper-named; unlit, inedible, portable; opaque, closed, unopenable, unlocked
list grouping key: none
printed name: "black bag"
printed plural name: "containers"
indefinite article: none
description: "A small black bag, made of stif cloth. "
initial appearance: none
thing condition: small
carrying capacity: 100

>close black
It isn't something you can close.

* * *

>open bag
You open the black bag, revealing a screwdriver, a roll of plumbing tape and a wrench.

>take all from bag
screwdriver: Yours.
roll of plumbing tape: Yours.
wrench: Yours.

>x screwdriver
A big screwdriver, with a green-transparent handle.

>unscrew door
Nothing obvious happens.

>x door
This door is from the days plastic was just invented, and someone thought this combination of plastic and mettal would look modern.  The hinge is screwed to the wall, with cracks in the tiles running from the holes.

>take screw
That's fixed in place.

>take hinge
That's fixed in place.

>open hinge
(first unlocking the plastic door)
You lack a key that fits the plastic door.

>enter hinge
That door leads nowhere!