"Get the hell off of my property!" the man yelled.
 but we couldn't, we where frozen in fear. Violet screamed, the rest of us didn't have the breath. The man cought up to us, grabbed Sean by his color as if he weighed nothing.
 "Were going allready" Daisy yelled, but the man wouldn't listen. Josh started running again, but tripped on a tree branch, and the man cought him too.
HINT: You can use Become (character) to run into another Daisy, Josh, Sean, or Violet. 
madhouse
An Interactive Fiction by Maurits
Release 1 / Serial number 151111 / Inform 7 build 6L38 (I6/v6.33 lib 6/12N) SD

You could hardly look. The man was holing you by your arm, and suddendly, you where flying. "there you go, no way of gettting out of there!" the man sneered. You seemed to hit some stairs, and you kept rolling down, and down. You thought you where still rolling when you opened your eyes, but instead you find yourself lying still under a flight of stairs. You examine yourself, your head hurts, you have bruises everywhere, but miraculously havn' broken anything. 
cellar(as Violet)
A small concrete hole in the ground, a narrow concrete staircase leads up, with a iron door above it. Another door is set into the ground on the east. The room is lit with some flickering tubelights on the ceiling. 

You can see a purple key and an iron door(locked) here.

>become daisy
You must have fainted, because at some point, you heared the man saying "Now I am going to leave this old place, and go on a long holiday, good thing you showed up the day before my holiday to Madagascar.!" You heared the sound of a car drive away, you look arround. 
stable(as Daisy)
This room probably used to contain all the old knights finest horses, but some later resident has used this place to keep some of his trash. A big double door leads south, while a small door is set into the east wall.A heap of trash, including a newspaper, a pencil case, a tyre and a cardboard box has been dumped in the corner.

>take blue pen
Yours.

>take newspaper
Yours.

* * *

>x gap
In the the crack under the door is a newspaper.

>l
garage(as Daisy)
You can see a pencil case (in which are three pencils, a blue pen and a black pen) here.

>poke key with blue pen
(I recomend saving before you try this, would you like to save first?)

>n
You poke the key, and it falls out the other side.

* * *

>take key
Yours.

>unlock small door
(with the plain key)
You unlock the small door.

>e
(Opening the small door first)
You open the small door.

hallway(as Daisy)
You can see a small door(open) here.

* * *

>take all
newspaper: Yours.
pencil case: Yours.
tyre: Yours.
cardboard box: Yours.
pencil: Yours.
pencil: Yours.
pencil: Yours.
blue pen: Yours.
blue pen: Yours.
black pen: Yours.
plain key: The keyhole is to small to reach the key.

* * *

>x box
You see nothing special about the cardboard box.

>open box
It isn't something you can open.

>south
That door leads nowhere!

>east
(Opening the small door first)
(first unlocking the small door)
You lack a key that fits the small door.

>find key
That's not a verb I recognise.

>search key
You find nothing of interest.

>open pencil case
It isn't something you can open.

>open case
It isn't something you can open.

>x case
In the pencil case are three pencils, two blue pens and a black pen.

>take pens
blue pen: Yours.
blue pen: Yours.
black pen: Yours.

>take pencil
(the pencil case)
Yours.

>x door
Which do you mean, the stable door or the small door?

>x small door
A dented wooden door. A simple lock is in the door, the man seems to have left the key in the other side of the door. There is a sizable gap between the door and the floor.

>take paper
Just how do you expect to get a thing like that here?

>take newspaper
Yours.

>put newspaper under the door
Which do you mean, the stable door or the small door?

>small
You slide the newspaper in the crack under the door.

>take pencil
(the pencil)
Yours.

>push pencil in keyhole
Which do you mean, a pencil or the pencil case?

>pencil
Which do you mean, a pencil or the pencil case?

>push key
Nothing obvious happens.

>push key with pen
Which do you mean, the black pen or a blue pen?

>blue
(I recomend saving before you try this, would you like to save first?)

>n
You poke the key, and it falls out the other side.

>pull the newspaper
I only understood you as far as wanting to pull the newspaper.

>ye
That's not a verb I recognise.

>yes
That was a rhetorical question.

>pull
What do you want to pull?

>newspaper
You find the key on the newspaper! It falls on the floor after you take the paper.

>take newspaper
You already have that.

>take key
Yours.

>open the door
Which do you mean, the stable door or the small door?

>small
(first unlocking the small door)
(with the plain key)
You open the small door.

* * *

>become josh
"here ya go" the man yelled "you will never get out of here untill you rot!" He threw you into the small room, you hit your head again some kind of box, you could just hear the man stomp out the door, locking it behind him. 
attic(as Josh)
A small room, probably later cut off from the rest of the cellar. The walls are made of wooden planks, pretty new relative to the old floor. The ceiling runs diogonally down one side, there is a window in the ceiling

You can see an inside attic window(locked) and a broad box (closed) here.

>x floor
The floor is made of very old planks, nailed to a layer of beams below.  One plank seems a bit loose.

* * *

>pull board
You pull at the board, and it comes of the ground a little, you pull a little more, and then the plank snaps in half, laving a gaping hole in the floor. 
Nothing obvious happens.

>enter hole
You first look down, but then decide not to and just jump. Luckily, you land on a bed after falling a couple of meters. The hole you came from is far up in the sky.

(Opening the hole in the floor first)
You open the hole in the floor.

green bedroom(as Josh)
A square room, newly painted, and with a nice, comby bed. Next to the bed is a cabinet .

You can see a cabinet here.

>enter hole
The hole in the ceiling to high to reach!

>undo
green bedroom
[Previous turn undone.]

>undo
attic
[Previous turn undone.]

>d
You first look down, but then decide not to and just jump. Luckily, you land on a bed after falling a couple of meters. The hole you came from is far up in the sky.

(Opening the hole in the floor first)
You open the hole in the floor.

green bedroom(as Josh)
A square room, newly painted, and with a nice, comby bed. Next to the bed is a cabinet .

You can see a cabinet here.

>u
The hole in the ceiling to high to reach!

>x bed
You see nothing special about the green bed.

>sit on bed
You get onto the green bed.

>l
green bedroom(as Josh) (on the green bed)
A square room, newly painted, and with a nice, comby bed. Next to the bed is a cabinet .

You can see a cabinet here.