"Get the hell off of my property!" the man yelled.
 but we couldn't, we where frozen in fear. Violet screemed, the rest of us didn't have the breath. The cought up to us, grabbed Sean by the color as if he weighed nothing.
 "Were going allready" Daisy yelled, but the man wouldn't listen. Josh started running again, but tripped on a tree branch, and the man cought him too.
HINT: You can use Become (character) to run into another Daisy, Josh, Sean, or Violet. 
madhouse
An Interactive Fiction by Maurits
Release 1 / Serial number 151108 / Inform 7 build 6L38 (I6/v6.33 lib 6/12N) SD

You could hardly look. The man was holing you by your arm, and suddendly, you where flying. "there you go, no way of gettting out of there!" the man sneered. You seemed to hit some stairs or something, and you kept rolling down, and down, You don't know how long you rolled, but your scared mind didn't reallize when the stairs ended, and now you seem to have been lying under the stairs for quite some time. You examine yourself, your head hurts, you have bruises everywhere, but miraculously havn' broken anything. 
cellar(as Violet)
A small concrete hole in the ground, a narrow concrete staircase leads up, with a iron door above it. Another door is set into the ground on the east. The room is lit with some flickering tubelights on the ceiling.

>purloin violet
[Can't move yourself: it would contain itself.]

>purloin daisy
[Purloined.]

>purloin josh
[Purloined.]

>purloin sean
[Purloined.]

>sean, n
Sean is unable to do that.

>drop sean
Dropped.

>sean, e
Sean goes east.

>daisy, e
Daisy is unable to do that.

>drop daisy
Dropped.

>drop all
(Josh at Josh)
You lack the nerve when it comes to the crucial moment.

>i
You are carrying:
  Josh

>drop josh
Dropped.

>josh, e
Josh goes east.

>e
mainanance room(as Violet)
This is a long room, with a low ceiling. A doorway goes west. It is full of narrow pipes, wide pipes, blue pipes, red pipes, leaking pipes, clean pipes, yea, and I forgot to mention pipes! 

You can see Josh and Sean here.

>josh, turn tap
Josh turns the tap of the narrow pipe.

>x tap
The type of pipe with a circle and spokes, its made of metal, and then somebody made a attempt to paint it, or maybe some paint leaked onto it.

* * *

>e
mainanance room(as Violet)
This is a long room, with a low ceiling. A doorway goes west. It is full of narrow pipes, wide pipes, blue pipes, red pipes, leaking pipes, clean pipes, yea, and I forgot to mention pipes!

>turn tap
You turn on the tap. You hear the gurgling noise of air being pushed out the tap.

>x tap
The type of pipe with a circle and spokes, its made of metal, and then somebody made a attempt to paint it, or maybe some paint leaked onto it. It makes a gurgling noise.

>turn tap
You turn off the tap.

>x tap
The type of pipe with a circle and spokes, its made of metal, and then somebody made a attempt to paint it, or maybe some paint leaked onto it.

* * *

>turn tap
You turn off the tap.

>become sean
You put up a good fight, you kept biting, scratching and prying. "you think you are smart resisting like that? Stupid lemon you are!" the man yelled. He threw you into the nearest door, and then slammed it. You heared sounds like a heavy wooden object was moved in front of the door. "You will never get out of there, moron!" he yelled as he walked further down the encoing hallway outside. 
Darkness
It is pitch dark, and you can't see a thing.

>feel
You search the walls, and finally find a lightswitch.

bathroom(as Sean)
You can see a bathroom sink (in which is an orange key) here.

>turn tap
You turn on the tap.

>x tap
It's pretty much a metal tube bent into a upside-down U-shape, it's pretty rusty on some places, but shiny on others.

>become violet
mainanance room(as Violet)
This is a long room, with a low ceiling. A doorway goes west. It is full of narrow pipes, wide pipes, blue pipes, red pipes, leaking pipes, clean pipes, yea, and I forgot to mention pipes!

>turn tap
You turn on the tap. You hear the gurgling noise of air being pushed out the tap.

>become sean
bathroom(as Sean)
You can see a bathroom sink (in which is an orange key) here.

>x tap
It's pretty much a metal tube bent into a upside-down U-shape, it's pretty rusty on some places, but shiny on others. A thin stream of watter is comming out.

* * *

>e
mainanance room(as Violet)
This is a long room, with a low ceiling. A doorway goes west. It is full of narrow pipes, wide pipes, blue pipes, red pipes, leaking pipes, clean pipes, yea, and I forgot to mention pipes!

>turn on tap
It isn't something you can switch.

>turn tap
You turn on the tap. You hear the gurgling noise of air being pushed out the tap.

>x tap
The type of pipe with a circle and spokes, its made of metal, and then somebody made a attempt to paint it, or maybe some paint leaked onto it.

>become sean
You put up a good fight, you kept biting, scratching and prying. "you think you are smart resisting like that? Stupid lemon you are!" the man yelled. He threw you into the nearest door, and then slammed it. You heared sounds like a heavy wooden object was moved in front of the door. "You will never get out of there, moron!" he yelled as he walked further down the encoing hallway outside. 
Darkness
It is pitch dark, and you can't see a thing.

* * *

>turn tap
You turn on the tap.

>x tap
It's pretty much a metal tube bent into a upside-down U-shape, it's pretty rusty on some places, but shiny on others. A thin stream of watter is comming out.

>become violet
mainanance room(as Violet)
This is a long room, with a low ceiling. A doorway goes west. It is full of narrow pipes, wide pipes, blue pipes, red pipes, leaking pipes, clean pipes, yea, and I forgot to mention pipes!

>x tap
The type of pipe with a circle and spokes, its made of metal, and then somebody made a attempt to paint it, or maybe some paint leaked onto it. It makes a gurgling noise.

* * *

>relations
Lock-fitting relates one thing ( called the matching key ) to various things:
  The orange key  >=>  the inside attic window
  The purple key  >=>  the broad box
opposing relates one base half door to another ( called the back side ):
  The inside attic window  ==  the outside attic window
Flowing relates one tap to various taps:
  The sink tap  >=>  the tap of the narrow pipe

* * *

>fush yourself
That's not a verb I recognise.

>flush me
You can't flush that!

* * *

>become sean
You put up a good fight, you kept biting, scratching and prying. "you think you are smart resisting like that? Stupid lemon you are!" the man yelled. He threw you into the nearest door, and then slammed it. You heared sounds like a heavy wooden object was moved in front of the door. "You will never get out of there, moron!" he yelled as he walked further down the encoing hallway outside. 
Darkness
It is pitch dark, and you can't see a thing.

>feel
You search the walls, and finally find a lightswitch.

bathroom(as Sean)
A longish room. To the east is a door, you can see a sink, a toilet, and a shower here.

>x toilet
(the toilet)
A pretty ordinary stock toilet. It is dry.

>look under toilet
(the toilet)
Behind the toilet you find a small tap, connected to a pipe, connected to the flush box.

>turn tap
Which do you mean, the sink tap or the small toilet tap?

>turn small toilet tap
Nothing obvious happens.

* * *

>x toilet
(the toilet)
A pretty ordinary stock toilet. It is dry.

>look behind toilet
Just how do you expect to get a thing like that here?

>look under toilet
(the toilet)
Behind the toilet you find a small tap, connected to a pipe, connected to the flush box.

>turn small tap
You turn on the tap.

>turn small tap
You turn off the tap.

>flush toilet
(the toilet)
You pull the appropriate lever, but nothing seems to happen.

>become violet
cellar(as Violet)
A small concrete hole in the ground, a narrow concrete staircase leads up, with a iron door above it. Another door is set into the ground on the east. The room is lit with some flickering tubelights on the ceiling.

>e
mainanance room(as Violet)
This is a long room, with a low ceiling. A doorway goes west. It is full of narrow pipes, wide pipes, blue pipes, red pipes, leaking pipes, clean pipes, yea, and I forgot to mention pipes!

* * *

>turn tap
You turn on the tap. You hear the gurgling noise of air being pushed out the tap.

>become sean
bathroom(as Sean)
A longish room. To the east is a door, you can see a sink, a toilet, and a shower here.

>flush toilet
(the toilet)
You pull the appropriate lever, but nothing seems to happen.

>turn tap
Which do you mean, the sink tap or the small toilet tap?

>turn small tap
You turn on the tap.

>flush toilet
(the toilet)
You flush the toilet.

>flush
What do you want to flush?